Wonder - Shawn Mendes
Bet You Wanna  - BLACKPINK
Runnin - 21 Savage
Don‚Äôt Stop  - Megan Thee Stallion
Outta Time  - Bryson Tiller
Not Another Love Song - Ella Mai
Lie Like This - Julia Michaels
Fallin' - Why Don't We
heart won't let me - LANY
Savage Love   - Jawsh 685
Jeanie  - Jim-E Stack
Stuck On You - Giveon
Come Over - Jorja Smith
Lemonade   - Internet Money
I'm Not Mad - Halsey
Still Have Me - Demi Lovato
Levitating  - Dua Lipa
POV  - Wiz Khalifa
Blood Walk - YG
La Luz - Kali Uchis
say it over  - Ruel
Mr. Right Now  - 21 Savage
Lovesick Girls - BLACKPINK
Better Than We Found It - Maren Morris
body bag  - Machine Gun Kelly
Big A$AP  - A$AP Ferg
Demons and Monsters - 347aidan
Lifetime - Romy
Gun Smoke - Stunna 4 Vegas
Bop It  - Fivio Foreign
Outside - Oliver Malcolm
Something You Like - merci, mercy
Salt Licorice  - Radio Edit - J√≥nsi
How Was Your Day? - beabadoobee
Lie To Me - Queen Naija
Oops   - Lost Kings
Roller Rink - dempsey hope
Virtual Aerobics - Wallows
oops! - Yung Gravy
october's lullaby  - Savage Ga$p
Chocolate Pomegranate - Ari Lennox
Mu√±eca - Gabriel Garz√≥n-Montano
Leave Virginia Alone - Tom Petty
HIGHER - Bishop Briggs
Think I'm Crazy - Two Feet
1,000,000 X Better - Griff
Pretty - Col3trane
PNE - Master Peace
wallflower - mxmtoon
All Love Everything - Aloe Blacc
The Change - JoJo
Man Down - YFN Lucci
Dos Uno Nueve  - Omar Apollo
MoneyOnMyMind - UPSAHL
 üêö
Two Ways - Trey Songz
Don't Go - Isabela Merced
Haunt You  - X Lovers
Rockstar - Mallrat
i'm glad that you found someone - sad alex
Free As We Wanna Be - Dawes
Dream On Me - Ella Henderson
Space - Becky Hill
Californian Soil - London Grammar
Twinkle - Hether
 üêö
Sofia - Tiny Meat Gang
Moment - Dagny
Cuss A Little - Kylie Morgan
Self Love - Savannah Cristina
 üêö
Boatloads feat. Jack Harlow - Smoke DZA
Training Day - Dougie F
Cry When I'm Gone - Dee Watkins
The Pink Phantom  - Gorillaz
Diet - Shamir
 üêö
Soapbox - Brent Cobb
Officer of Love - Caamp
Amen - Tom Grennan
Someone Special - Anna of the North
Must Stop  - ONR
tiny life - EVAN GIIA
You Only Die Once - Kelsy Karter
MEN - deryk
Kissez - Sevyn Streeter
Composure - Lud Foe
 üêö
I'd Rather Die Than Let You In - The Hunna
Halfway Down - Corey Taylor
Beautiful Drug - Bon Jovi
Baby - Brandon
Wild Child  - Noodah05