Songs with a ✅ contain verified annotations and/or lyrics!
The Weeknd - Starboy feat. Daft Punk ✅
Shawn Mendes - Patience
Gucci Mane - Bling Blaww Burr feat. Young Dolph
The Chainsmokers - Closer feat. Halsey  ✅
Kings of Leon - WALLS
TIEKS - Sunshine feat. Dan Harkna
Kranium - We Can feat. Tory Lanez
Green Day - Still Breathing
Skott - Amelia
Mona - In the Middle
Devon Baldwin - Hero
Shawn Mendes - No Promises
Mullally - Wonderful
Ariana Grande - They Don't Know
GRiZ - Gotta Push On feat. Brasstracks & Eric Krasno
MiC LOWRY - Oh Lord
Ty Dolla $ign - ???  feat. Migos
Tuvaband -  Running
6LACK - PRBLMS ✅
PJ - Tell Me feat. Jevon Doe
Bishop Briggs - Be Your Love
Young & Divine - Fux With the Boy 
Will Joseph Cook - Sweet Dreamer
How To Dress Well - Can't You Tell
Danny Brown - Really Doe feat. Kendrick Lamar, Ab-Soul & Earl Sweatshirt ✅
Bruce Springsteen - Growin' Up
Foreign Air - Better for It
Goldroom - Breaks
BANNERS - Into the Storm
Passenger - If You Go
Savi - Breathe It In feat. Bryce Fox
JoJo - FAB. feat. Remy Ma
Jack & Jack - All Weekend Long
Hey Violet - Guys My Age
Lucius - Pulling Teeth
IDER - King Ruby
Kevin Abstract - Empty
Night Riots - Don't Kill The Messenger
Hunter Hayes - Yesterday's Song
Mackenzie Thoms - Shout
Bloc Party - Stunt Queen
Warpaint - Whiteout
Shallou - Slow feat. RKCB
Huntar - Anyway
Brayton Bowman - WHAT'S REALLY GOOD?
Molly Moore - Imaginary Friends
STRFKR - Open Your Eyes
NxWorries - Lyk Dis feat. Anderson .Paak & Knxwledge
Liv Dawson - Reflection
Yelawolf - Daylight ✅
The Barr Brothers - Sometimes There's Wine
David Bowie - Somebody Up There Likes Me
The Last Bandoleros - I Don't Want To Know
Felipe Muñiz - Deje de Amar feat. Marc Anthony
Matoma & Becky Hill - False Alarm 
Britt Nicole - Pave