Bazzi - Paradise
Jonas Brothers - Cool
Khalid - Free Spirit
Anitta - Poquito
BLACKPINK - Kill This Love
Lil Nas X - Old Town Road - Remix
Ariana Grande - MONOPOLY 
Brooks & Dunn - Neon Moon  - with Kacey Musgraves
KIDDO - Coming Down
Still Woozy - Lava
bülow - Get Stüpid
The BoyBoy West Coast - Bottoms Up
Anderson .Paak - Make It Better 
Khalid - Don't Pretend
Bazzi - Caught In The Fire
MAX - Love Me Less 
Jennifer Lopez - Medicine
Khalid - Outta My Head 
Karol G - Punto G
Austin Brown - Backup Plan
Vampire Weekend - This Life
Matt Maeson - I Just Don't Care That Much
SAFE - Paid In Full
Martin Garrix - Mistaken 
Omar Apollo - Friends
Young Dolph - By Mistake  
Tayla Parx - Rebound 
Sara Bareilles - A Safe Place to Land 
The Lumineers - Gloria
Spencer Barnett - Suicide Note
Amber Mark - Mixer
Aventura - Inmortal
Banx & Ranx - Speaker 
Gallant - Gentleman  - Remix
Ingrid Andress - More Hearts Than Mine
Matt Simons - Dust
Judah & the Lion - 7000x
Famous Dex - Rockstar Lifestyle
Jai Wolf - Still Sleeping
Rita Ora - Big Yellow Taxi - Recorded at Spotify Studios NYC
Circa Waves - The Way We Say Goodbye
Tiësto - Trouble 
Push Baby - Mama's House
Noname - Song 32
MARINA - To Be Human
Tom Odell - Summer Day
Dennis Lloyd - GFY
Cheat Codes - Be The One 
AURORA - The Seed
B00TY - Trust Me 
The Head and the Heart - Honeybee
AJR - Dear Winter
Jasmine Thompson - some people
The National - Light Years
Little Big Town - The Daughters
Cuco - Hydrocodone
Yung Gravy - Magic
Badd Tattoo - Alive
Loren Gray - Options
Hatchie - Stay With Me
Valerie Broussard - Deeper
ASTN - Tidal Wave
Tash Sultana - Can't Buy Happiness
SoMo - Neck
Kevin Rudolf - I Will Not Break
Wilder Woods - Sure Ain't
Conro - Remember You
Silver Sphere - boys in bands
JPEGMAFIA - The Who
Alison Wonderland - Peace
Lostboycrow - Santa Fe
DREAMERS - Insomniac
Jordan McGraw - FLEXIBLE
Snoh Aalegra - You
Yuna - Forevermore
Cyn - Terrible Ideas
GRiZ - Maybe
Tash - Euphemism
No Suits - Boat to Bermuda
William Bolton - Keep Me Waiting
Ashe - Bachelorette
11:11 - All Year
Mechi Pieretti - Conexión
New Years Day - Come For Me
PUP - Morbid Stuff
Silvana Estrada - Carta
Jacob Latimore - Mine 
Bassnectar - Dive 
Asketa - Real Love
Courtney Hartman - January First
BETWEEN FRIENDS - blushing!
Gia Woods - Keep On Coming
The Brave - Burn
Anthony D'Amato - Passing Through
Sego - Give Me
KO - MOOD
AWAZE - Break a Bone
Winnetka Bowling League - Slow Dances