May 29, 2019 Update
Cross Me - Ed Sheeran
Stay - Post Malone
Paradise - Bazzi
What I Like About You - Jonas Blue
Look Back At It - A Boogie Wit da Hoodie
bad guy - Billie Ellish
Outta My Head - Khalid, John Mayer
Old Town Road  - Little Nas X, Bille Ray
I Think She Like Me - Rick Ross, Ty Dolla $ign
Shot Clock - Ella Mai
My Bad - Khalid
Two of Us - Louis Tomlinson
Streatham - Dave
Never go Back - Dennis Lloyd
Girls Need Love - Summer Walker, Drake
Ye - Burna Boy
Talk - Khalid, Disclosure
a lot -21 Savage
What A Time - Julia Micheals, Niall Horan
For You - Liam Payne, Rita Ora
bury a friend - Billie Ellish
i'm so tired - Luav, Troye Sivan
Switch -6LACK
Guatemala - Rae Sremmurd, Swae Lee
Levithan - G-Eazy, Sam Martin
Lucky Strike - Troye Sivan
La Di Da - Lennon Stella
Arms Around You - XXXTENTACION, Lil Pump ft. Maluma, Swae Lee
thank u, next - Ariana Grande
Seasons -6LACK, Khalid
Sunflower - Post Malone, Swae Lee
Love Made Me Do It - Cheryl
Love Someone - Lukas Graham
ZEZE - Kodack Black, Offset
Ruin My Life - Zara Larsson
Suncity - Khalid, Empress of
QUEENS - The Blaze
There's No Way - Lauv, Julia Michaels
Better - Khalid
Without Me - Halsey
Silence - Toonorth
Almost Home - Sugi.wa
1950 - King Princess
Jocelyn Flores - XXX TENTACION
Start Again - One Republic, Logic
Natural - Imagine Dragons
Come Over - The Internet
Evergreen - YABBA
Wake Up In The Sky - Gucci Mane, Bruno Mars
Self Care - Mac Miller
Younger - Ruel
8 Letter - Why Don't We
Nappy Wonder - Blood Orange
New Light - John Mayer
Happier - Marshmello, Bastille
Beautiful - Bazzi
Girls Like You - Maroon 5 , Cardi B
Don't Matter to Me - Drake, Michael Jackson
Superhero - Lauv
Slow - Liam Payne
U Remind Me - Usger
Englishman In New York - Sting
Dark Fantasy - Kanye West
Novacane - Frank Ocean
Blinded By Your Grace - Stromzy, MNEK
Karaoke - Drake
Depend On It - Liam Payne
Who Says - John Mayer
Be Alright - Dean Lewis
Slow Hands - Niall Horan
Youth - Shawn Mendes , Khalid
Home With You - Liam Payne
Jump - Julia Michaels
I Wanna Be Your Lover - Prince
Sweet Creature - Harry Styles