Bazzi - No Way!
Megan Thee Stallion - Hot Girl Summer 
Katy Perry - Small Talk
Labrinth - All For Us - from the HBO Original Series Euphoria
Bon Iver - Naeem
Alessia Cara - Rooting For You
Trippie Redd - !
Ty Dolla $ign - Hottest In The City
Rick Ross - Running the Streets 
Slipknot - Critical Darling
TOOL - Fear Inoculum
SiR - Hair Down 
Cautious Clay - Swim Home - From 13 Reasons Why - Season 3 Soundtrack
Social House - Tropical Rain
BROCKHAMPTON - IF YOU PRAY RIGHT
Miranda Lambert - Mess with My Head
Lana Del Rey - Looking For America
SAINt JHN - Anything Can Happen 
Boy In Space - Cold
Cashmere Cat - EMOTIONS
Bazzi - Live Forever
DRAM - The Lay Down 
Bon Iver - Salem
Tori Kelly - Coffee
mxmtoon - blame game
Mallrat - Charlie
iann dior - pouring
Cousin Stizz - Toast 2 That 
Quality Control - Once Again
Mike Posner - Prince Akeem
YEBBA - Where Do You Go
Bas - Amnesia 
THEY. - Til I Die
Mary J. Blige - Know
Eladio Carrion - Kemba Walker
Dennis Lloyd - Like A Stone  - Recorded at Electric Lady Studios NYC
R.LUM.R - Boys Should Never Cry
Kevin George - Wait
AUGUST 08 - Good Girls 
halfâ€¢alive - Maybe
nothing,nowhere. - Destruction
Leah Kate - Visions
Blueface - Gang 
AJ Mitchell - Slow Dance
Louis The Child - Too Close 
Grace VanderWaal - Waste My Time
Audrey - Time
Ruel - Face To Face
ayokay - Move On
CXLOE - SICK
T-Pain - Girlfriend 
The Regrettes - Has It Hit You?
Phantogram - Mister Impossible
Noah Schnacky - I'll Be The One
Lady Antebellum - Pictures
Justin Caruso - Good Parts
Pete Yorn - Idols 
KIRBY - Kool Aid
Jidenna - Sou Sou
Elderbrook - Something About You 
Barns Courtney - Hollow
Djo - Chateau 
$NOT - Vision 
Higher Brothers - Friends & Foes 
Nasty Cherry - Live Forever
Ra Ra Riot - Dangerous
Kojo Funds - I Like 
Lost Frequencies - Sun Is Shining
Anson Seabra - Broken
Childish Major - For You
Snoop Dogg - Let Bygones Be Bygones
Cavetown - Feb 14
Lil Tjay - F.N
Theophilus London - Pretty 
Ella Eyre - Mama
Camilo - Tutu
GNAR - CABBAGE
Fetty Wap - Zoo 
Remi Wolf - Shawty
The Score - Rush
Wilder Woods - What Gives You The Right
Piso 21 - Mami
PJ Morton - PRACTICING 
Grip - 911 
Dirty Heads - Fear & Love
Pixies - Catfish Kate
Christian French - bright side of the moon
Skylar Grey - New Kind Of Love - From "Four Weddings And A Funeral"
Ugly God - Batman
G Perico - Big Raccs 
BUNT. - Lucky Day 
Jake Miller - NERVOUS
Q Money - Whole 100
Half Moon Run - Then Again
Scarypoolparty - Cholo Love - Superscary Mix
Bonbon Anglais - Clear As Day
Ceraadi - Dumbstruck
P-Lo - Don't Think 