Lauren Daigle - The Christmas Song
Highlands Worship - Born in Bethlehem
Elevation Worship - O Come All Ye Faithful 
Tauren Wells - Like You Love Me
Chris Tomlin - Christmas Day 
Phil Wickham - This Year For Christmas
Danny Gokey - Until You
MercyMe - Have Yourself a Merry Little Christmas
Sidewalk Prophets - O Little Town Of Bethlehem 
Matthew West - Winter Wonderland
Marc Martel - Silver Bells 
I AM THEY - White Christmas
Cochren & Co. - Christmas With You
TobyMac - All I Need For Christmas 
Switch - Joy
ELEVATION RHYTHM - HEARTBEAT
Hollyn - Christmas Time Is Here
The Afters - Joy Unto The World
Riley Clemmons - Silent Night
We Are Messengers - This Is Jesus
Plumb - Behold
Ryan Stevenson - Home for Christmas
Audrey Assad - Your Peace Will Make Us One 
Red Rocks Worship - O Come All Ye Faithful
Jars Of Clay & SHEL - Something New
Sovereign Grace Music - Christ Our Glory 
Matt Boswell - Sing We The Song Of Emmanuel  
Avalon - Majesty
Lincoln Brewster - Joy to the World
Holly Starr - Let It Snow
Big Daddy Weave - Joy! He Shall Reign
Christy Nockels - Make Good Your Christmas Day  
Sara Groves - O Come O Come Emmanuel
Jim Brickman - The Gift
Sandra McCracken - The Space Between 
Mallary Hope - A Baby Changes Everything
Andrew Peterson - While Shepherds Watched
Rhett Walker - Have Yourself a Merry Little Christmas
John Tibbs - Put a Little Love in Your Heart
Alive City - Silent Night
Planetshakers - Angels We Have Heard On High
Matthew Parker - Mistletoe Meltdown
Rachael Lampa - Silent Night
All Things New - The Joy of Christmas
The Worship Initiative - Sing We the Song of Emmanuel 
The McCrary Sisters - What Child Is This? 
The Oak Ridge Boys - Angels
The Sing Team - Joy to the World
Keith & Kristyn Getty - In Christ Alone / I Stand Amazed   
Caleb and Kelsey - Away in a Manger 
Nashville Life Music - Gloria
Quinten Coblentz - Christmas Day
Andrew Ripp - Redwoods
Fresh Life Worship - Motion
Covenant Worship - Make Room
Ginny Owens - Strangers No More
Bryan Boliver - Still
Social Beingz - Legacy
Eagle Brook Music - Stand in Victory
The Sound - Make It Count