2 Chainz - Bigger Than You 
Nicki Minaj - Bed 
Alessia Cara - Growing Pains
Martin Garrix - Ocean 
Troye Sivan - Dance To This 
Kygo - Born To Be Yours
Bebe Rexha - I'm a Mess
Rudimental - Let Me Live 
5 Seconds of Summer - Valentine
Nas - Cops Shot The Kid
Mike Shinoda - Make It Up As I Go 
Luis Fonsi - Calypso
Ruel - Not Thinkin' Bout You
King Princess - Upper West Side
Jay Rock - Tap Out 
Christina Aguilera - Maria
Loote - Wish I Never Met You
Dan + Shay - Keeping Score 
Cole Swindell - Reason to Drink
Daddy Yankee - Zum Zum
Charlotte Lawrence - Wait Up
David Guetta - Your Love
Death Cab for Cutie - Gold Rush
Jason Mraz - Unlonely
G Herbo - That's How I Grew Up 
French Montana - New Thang
Nicki Minaj - Rich Sex 
Lecrae - Plugged In
Marshmello - Check This Out
GoldLink - Got Friends
Chromeo - Don't Sleep 
Baka Not Nice - Junior High
Whethan - Superlove 
Bhad Bhabie - Trust Me 
Jorja Smith - Blue Lights
VHS Collection - Animal
Cigarettes After Sex - Crush
Chris Lane - Fishin'
YUNGBLUD - California
Dirty Projectors - Thatâ€™s A Lifestyle
Roo Panes - My Sweet Refuge
BLACKPINK - DDU-DU DDU-DU
grandson - Stick Up
Rayland Baxter - Strange American Dream
Noah Kahan - Come Down
Victory - Weatherman
The Vamps - Just My Type
DNCE - TV In The Morning
RL Grime - Undo
Lil Halima - Train
Tim Mason - Lest We Forget
Steel Banglez - Your Lovin' 
Francesca Battistelli - The Breakup Song
Malte Ebert - Rather Be
All Time Low - Everything Is Fine
Eighty Ninety - Dream
Spiritualized - A Perfect Miracle
Hotel Garuda - Blurry Eyes 
Freeway - All Falls Down
R+R=NOW - Needed You Still
FINNEAS - Landmine
CHVRCHES - Stay 
Active Bird Community - Unwind With Me
Feki - Don't Doubt
Young the Giant - Simplify
Culture Abuse - Dip
Mura Masa - Move Me
BONNIE X CLYDE - Do It All Over
Tobe Nwigwe - EBT TO BET
Betty Who - Just Thought You Should Know
State Champs - Dead and Gone
SYML - Where's My Love 
Yellow Claw - Waiting
Dustin Tebbutt - Love Is Blind
Sigrid - Focus 
FRANKIE - Ghost
GOLDN - Mama I'm So Sorry
Melody's Echo Chamber - Cross My Heart 
Gorillaz - Fire Flies
Calpurnia - Blame
Maisie Peters - I'll Be There For You 
Garren Sean - The Jam
The Stray Birds - Nothing to Say About It Now
Emma Louise - Wish You Well
Rico Nasty - In The Air 
Dounia - Avant-Garde
Tofer Dolan - Baby Daddy
Joey Bada$$ - Survival Tactics 
Houndmouth - Modern Love
Donna Missal - Keep Lying
Maroon 5 - Three Little Birds
Steve Moakler - Crazy Does
So Below - Crying on the Bathroom Floor
Noah Cyrus - Lately
Andy Jenkins - Illuminated
Just Loud - Angels and Demons
Novo Amor - Birthplace
Oso Oso - gb/ol h/nf
ORKID - Obvious
Huntar - Carousel