Post Malone - Circles
Billie Eilish - bury a friend
Ariana Grande - break up with your girlfriend, i'm bored
Ed Sheeran & Travis Scott - Antisocial
Bad Bunny - NI BIEN NI MAL
Khalid - Saturday Nights
J Balvin - Blanco
Drake - Behind Barz
Ozuna - Devuelveme
XXXTENTACION - SAD!
Daddy Yankee - Que Tire Pa Lante
Anuel AA - Por Ley
Taylor Swift - You Need To Calm Down
Shawn Mendes - If I Can't Have You
Queen - Another One Bites The Dust
Eminem - Lose Yourself
Juice WRLD - Robbery
BTS - Make It Right
Travis Scott - HIGHEST IN THE ROOM
Imagine Dragons - Bad Liar
Camila Cabello - Living Proof
Marshmello & Kane Brown - One Thing Right
Farruko - Vuelvo a Nacer
Sam Smith - How Do You Sleep?
Halsey - Graveyard
Maluma - 11 PM
Kanye West - Follow God
Lady Gaga & Bradley Cooper - Shallow
The Chainsmokers - Push My Luck
Justin Bieber - Sorry
J. Cole - MIDDLE CHILD
David Guetta - Stay  feat. Raye
Maroon 5 - Memories
Swae Lee - Sextasy
Chris Brown - Overtime
Beyoncé - Formation
Calvin Harris & Rag'n'Bone Man - Giant
The Beatles - Let It Be
The Weeknd & Daft Punk - Starboy
Bruno Mars - 24K Magic
Nicky Jam - Tequila
Rihanna - Disturbia
Coldplay - Orphans
Lil Nas X - Old Town Road
Avicii - Heaven
Panic! At The Disco - High Hopes
A Boogie Wit da Hoodie - Look Back at It
Cardi B - Press
Tyga - SWISH
Kygo & Whitney Houston - Higher Love