January 1st
Cali Swag District - The District
Del the Funkee Homosapien - Iller than Most
ILL Chris - Odd Man Out
Jerm 9V - Material of Dreams
Nacho Picasso - Trances with Wolves - The Prixtape
-topic. - Be Good & Do Well
Traphik  - No Jokes Mixtape
Young Scooter - Street Lottery 2
January 2nd
Baracuda & Modulok - Hydra
French Montana - Coke Boys 4
January 5th
Bones - Deadboy
January 6th
Alexander Dreamer - Dancing With The Devil
Will Wildfire - Mansion 5503
January 7th
2$ Fabo - We Amongst U
Dj Pain 1 - Painkillerz 3
Kid Ink - My Own Lane
Killa Kali - Cadena De Oro
Kristoff Krane - I Freestyle Life {2005-2013}
Lantana - Live From Lantana
Maffew Ragazino - Brownsville's Jesus
Mark Deez & Kanis Lu - Of Beasts & Men
Test - Crabs & Blow
January 8th
Allen Poe - Pocket Full of Ohms
Human  - I Am Human
January 9th
Madesicc Muzicc - Gas Station 2: The Lost Files
January 10th
Cadalack Ron & Paris Zax - Junkies in Paris EP
January 12th
Charlie Muscle - Gifted and Dedicated
January 13th
Rocky Diamonds - The Markus Shaw EP
Ryshon Jones - Hope is a Dangerous Thing
January 14th
A-Plus & Aagee - Molly’s Dirty Water
Black Knights - Medieval Chamber
Coke Boy Brock - These Streets Don't Love U
Mr. Bigz - My Funked Up Soul
Strap Da Fool - All In 2
Zion I - The Masters of Ceremony EP
January 17th
Flamez  - The Apex
Truck North - Murder By Mourning
January 19th
Vonny Del Fresco - After the Fall
January 20th
Sean Leon - narcissus, THE DROWNING OF EGO
January 21st
Chris Gatsby - Middleground: Morals + Money
First Division - The Critical Path Pt. 1
Jonny - Amnesia
Mac Dre - Musical Life of Mac Dre 3: Young Black Brotha
Oun-P - F.A.C.T.S. 2
Ray West & OC - Ray's Café
Sammy Warm Hands - Bears Repeating
The Alchemist & Evidence - Lord Steppington
The Jacka & Laroo - Never Be The Same — Season II: No Mercy
Trae tha Truth & World's Freshest - The Tonite Show
Ty Dolla Sign - Beach House EP
SonReal - One Long Day
January 22nd
Cashy - Platinum Plus
Dom O Briggs - Reset
January 23rd
Hollywood FLOSS - Spirit of Competition
Juan Deuce - Hi, Anxiety
Russ - Pink Elephant
MURS x Curtiss King - Shut Your TRAP
January 24th
Dan Rattomatic - Turbo Charged Cheese Dreams
Don Trip - Randy Savage
ILL Chris - iLL Chris Project
January 26th
Maiselph - Politically Incorrect
Voss - The Book Of Michael, Chapter 1: Reign Maker
January 27th
J57 - Wax Aesthetic
LIMS - In Too Deep
Naledge - Brain Power 2
January 28th
Adot-upt - Leaks…
Andy Mineo - Never Land
Cities Aviv - Come to Life
GDot & Born - Confidence Presents GDot & Born Featuring Ed Og
Grant Livesay - 183427106 LP
Isaiah Rashad - Cilvia Demo
J. Cole - Revenge of the Dreamers
Mattic - The Adventures Of Doctor Outer
Mello Music Group - Mandala Vol. 1, Polysonic Flows
Mello Music Group - Mandala Vol. 2, Today’s Mathematics
Mike Slugga - Fast Check
MUMBLS - Wastoid
Oksanjin - Son of Pam
Pastor Troy - Crown Royal 4
Qwazaar & Batsauce - Stress Chasers EP
Topaz Jones - The Honeymoon Suite
January 29th
FOKN Bois - Coz Ov Moni 2  O​.​S
Jae X Cohen - Pennies
Jorun & Haslam - Jorun & Haslam 
Tanner Vision & Markitect - The DeadBeat Diarys
Ron Browz - The Christening 2
January 30th
Croosh - Cloudless Night
Dally Auston - Westside
Maniphest DestNE - Colossal Collaborations Vol. 2 “Pure Hip Hop”
Papoose - Hoodie Season Pt 2
January 31st
Daye Jack - Hello World
Noah & Horse Head - Delicate Genius
Spade-O - Unchained
DELAYED
Asher Roth - Retro Hash
Azealia Banks - Broke with Expensive Taste
Killa Sha - The Shepard
Limp Bizkit - Stampede of the Disco Elephants
Pharoahe Monch - P.T.S.D
Pro Era - Secc$ Tap.e Pt. 2
Riff Raff - Neon Icon
Veli Sosa - Time to Kill
Lil Durk - Fuckery