HIGHEST IN THE ROOM - Travis Scott
Bandit - Juice WRLD and YoungBoy Never Broke Again
Camelot - NLE Choppa
VIBEZ - DaBaby
223's - YNW Melly and 9lokknine
Hot - Young Thug and Gunna
BOP - DaBaby
F.N - Lil Tjay
Behind Barz - Drake
Bad Bad Bad - Young Thug and Lil Baby
Money In The Grave - Drake and Rick Ross
Stuck In A Dream - Lil Mosey and Gunna
RAW SHIT - DaBaby and Migos
Enemies - Post Malone and DaBaby
Panini Remix - Lil Nas X and DaBaby
Valentino - 24kGoldn
Baby - Quality Control, Lil Baby and DaBaby
Ballin' - Mustard and Roddy Ricch
On The Road - Post Malone, Meek Mill and Lil Baby
Did It Again - Lil Tecca
Baby Birkin - Gunna
Big Rocks - Quality Control, Offset and Young Thug
What's The Move - Young Thug and Lil Uzi Vert
BIG - Young M.A
Costa Rica - Dreamville, Bas, JID, Guapdad 4000, Reese LAFLARE, Jace, Mez, Buddy, Smokepurpp and Ski Mask The Slump God
Mac 10 - Trippie Redd, Lil Baby and Lil Duke
Ransom - Lil Tecca
Mood Swings - A Boogie Wit da Hoodie
Saint-Tropez - Post Malone
No Guidance - Chris Brown and Drake
Juicy - Doja Cat and Tyga
Through Da Storm - Polo G
Broke As Fuck - YBN Cordae
Hot Girl Summer - Megan Thee Stallion, Nicki Minaj and Ty Dolla $ign
Shots - Lil Tecca
Self Control - YoungBoy Never Broke Again
Hot Shower - Chance the Rapper, MadeinTYO and DaBaby
Babushka Boi - A$AP Rocky
Bussin - Blueface and Lil Pump
Bezerk - Big Sean, A$AP Ferg and Hit-Boy
Satish - Tee Grizzley
Pose - Yo Gotti and Lil Uzi Vert
My Type - Saweetie
She Like I'm Like - Young M.A
By My Lonely - Kevin Gates
Jet Lag - A$AP Ferg
Big Booty - Gucci Mane and Megan Thee Stallion
No Cap - 83 Babies and Rich The Kid
Choosy - Fabolous, Jeremih and DaVido
Playing Games - Summer Walker and Bryson Tiller