Maroon 5 - Wait
Sam Smith - Nothing Left For You
Offset & Metro Boomin - Ric Flair Drip
Bad Bunny - Sensualidad 
Kelsea Ballerini - End of the World
Kygo & Oliver Nelson - Riding Shotgun 
Big Sean & Metro Boomin - Pull Up N Wreck 
Blackbear - santa monica & la brea
David Guetta & Afrojack - Dirty Sexy Money 
N.E.R.D & Rihanna - Lemon
Willow - Boy
Lil Xan - Far
Shallou - You and Me
Lil Uzi Vert - The Way Life Goes  - Remix
Chris Brown - Tough Love
Olivia O'Brien - No Love
Grace VanderWaal - Florets
Chris Stapleton - Scarecrow In The Garden
Miguel - Told You So
U2 - Get Out Of Your Own Way 
Anti-Flag - Trouble Follows Me
Allie X - Casanova Remix 
MAX - Meteor
MILCK - Quiet
Lil Baby & Marlo - Whatchu Gon Do 
Future Jr. - Sentimental Trick
Madison Beer - Say It To My Face
Shawn Mendes - Bad Reputation - MTV Unplugged
Blake Shelton - Hangover Due
Pinegrove - Intrepid
Joji - Will He
DJ Premier - Our Streets 
Ace Hood - 3 Bless
Freya Ridings - Lost Without You
Petit Biscuit - Beam
Ryan Riback - Do You Care 
Luke Bryan - Most People Are Good
Cold Arizona - Open Highway Head Start
Matthew And The Atlas - No Dreamer
Turnstile - Real Thing
CyHi The Prynce - Dat Side 
The Fratellis - The Next Time We Wed
Eves Karydas - There For You
Whole Doubts - Leave 
Yaeji - raingurl
Maluma - Coraz√≥n 
Prince Charlez - Think High
Andy Grammer - Smoke Clears
Switchfoot - I Won't Let You Go - Remix 
Sia - Santa's Coming For Us
Feist - Hey, That's No Way To Say Goodbye
BANNERS - Empires On Fire
Vance Joy - Like Gold
Grace Weber - More Than Friends
JONES - Something Bout Our Love
Gorillaz - Garage Palace 
Grizzly Bear - Mourning Sound - Live from Spotify Studios NYC