Stevie Nicks - Edge of Seventeen 
Joan Jett & The Blackhearts - I Love Rock 'N Roll
Blondie - One Way Or Another
The Cranberries - Zombie
4 Non Blondes - What's Up?
Big Brother & The Holding Company - Piece of My Heart 
Heart - Barracuda
Pat Benatar - Hit Me With Your Best Shot 
Alabama Shakes - Don't Wanna Fight
Amy Winehouse - Back To Black
K.Flay - Blood In The Cut
HAIM - The Wire
Hole - Celebrity Skin
Tash Sultana - Jungle 
Florence + The Machine - Dog Days Are Over
Saint Agnes - Welcome to Silvertown
Alanis Morissette - You Oughta Know 
LP - Lost on You
Patti Smith - Because the Night
Joan Jett & The Blackhearts - I Hate Myself for Loving You
Paramore - Misery Business
Carly Simon - You're so Vain
Fleetwood Mac - Dreams 
Elle King - Ex's & Oh's
The Cardigans - Lovefool
Dorothy - Raise Hell
No Doubt - Just A Girl
Hannah Wicklund & The Steppin Stones - Bomb Through the Breeze
The Interrupters - She's Kerosene
The Ting Tings - Shut Up and Let Me Go
The Breeders - Cannonball
Meg Myers - Running Up That Hill
Annie Lennox - I Put A Spell On You
Grace Potter & The Nocturnals - Paris 
Jade Bird - I Get No Joy
The Runaways - Cherry Bomb
Yeah Yeah Yeahs - Heads Will Roll 
PJ Harvey - Down By The Water
Bishop Briggs - River
Fleetwood Mac - Everywhere 
YONAKA - Teach Me To Fight
Juliet Simms - It’s A Man’s, Man’s, Man’s World 
Mazzy Star - Fade Into You
Letters To Cleo - I Want You To Want Me 
Halestorm - I Miss The Misery
The New Respects - Trouble
Grace Mitchell - Kids 
The Pretty Reckless - Take Me Down
PVRIS - You and I
Garbage - #1 Crush
Joan Jett & The Blackhearts - Crimson and Clover
Dead Sara - Weatherman
Bleached - Wednesday Night Melody
Evanescence - Bring Me To Life
The Kills - Future Starts Slow
Björk - Army Of Me
Jefferson Airplane - Somebody to Love
Emily Wolfe - Atta Blues
The Beaches - Give It Up
'Til Tuesday - Voices Carry 
Edie Brickell & New Bohemians - What I Am
Best Coast - Feeling Ok
The Go-Go's - We Got The Beat 
Metric - Help I'm Alive
The Aces - Stuck
Rilo Kiley - Portions for Foxes
MS MR - Hurricane
Luscious Jackson - Naked Eye
Flyleaf - All Around Me
Gin Wigmore - Black Sheep
Marmozets - Captivate You
Lana Del Rey - Young And Beautiful
Kendra Morris - Banshee
Tigress - Power Lines
First Aid Kit - My Silver Lining
L7 - Pretend We're Dead
In This Moment - Oh Lord
New Years Day - Skeletons
Eliot Sumner - Halfway To Hell
Veruca Salt - Seether
Of Monsters and Men - Crystals
Joan Jett & The Blackhearts - Cherry Bomb
Lita Ford - Kiss Me Deadly
Indigo Girls - Closer to Fine
Melissa Etheridge - Like The Way I Do
Lissie - Daughters
Brandi Carlile - The Story
Cilver - I'm America
Kate Bush - This Woman's Work
BLOXX - Curtains
The Regrettes - California Friends
Liz Phair - Never Said 