Lupe Fiasco - Tetsuo and Youth
Joey Bada$$ - B4.DA.$$
Trinidad Jame$ - No One Is $afe
Rae Sremmurd - Sremmlife
Viet Cong - Viet Cong
Future - Beast Mode
Panda Bear - Panda Bear Meets the Grim Reaper
2 Chainz - Tru Jack City
Punch Bros - Phosphorescent Blues
Subterranean Masquerade - The Great Bazaar
TUT - Preacher's Son
Nacho Picasso - Stoned and Dethroned
Open Mike Eagle - A Special Episode
Your Old Droog - Kinnison
Jaden Smith - This Is the Album
Bjork -Vulnicara
Leather Corduroys - Seasons
SkyBlew -Jazz For Autumn Kismet
Mount Eerie - Sauna
Drake -If You're Reading This It's Too Late
Cyhi the Prynce -Black Hystori Project 2
ICYTWAT - Dior Junts
Vic Spencer - The Cost of Victory
OG Maco - 15
Juicy J - Blue Dream & Lean 2
Big Sean - Dark Sky Paradise
Chief Keef - Sorry 4 the Weight
Gucci Mane - Views From Zone 6
Ghostface Killah - Sour Soul
Fashawn - The Ecology
Daye Jack - By the Ocean
Young L - Final Fantasy
Phony PPL - Yesterday's Tomorrow
Tuxedo - Tuxedo
Anjelihs - Metanoia
PeeWee Longway - The Blue M&M Vol. 2: King Size
Tree - Trap Genius
Cannibal Ox - Blade of the Ronin
Steff Martin - Legends Never Die
IshDARR - Old Soul, Young Spirit
Voli - The Wall
Maxo Kream - #Maxo187
Migos & Quality Control - Migo Ligo
EarthGang - Torba
Father John Misty - I Love You, Honeybear
Steven Wilson - Hand Cannot Erase
A-1 - Thurlian
Toundra - IV
Sussane Sundfor - Ten Love Songs
Dawn Richard - Blackheart
The Neal Morse Band - The Grand Experiment
Matana Roberts -Coin Coin Chapter Three
Doomtree - All Hands
John Carpenter - Lost Themes
Freddie Gibbs - Pronto
Purity Ring - Another Eternity
Mellow Music Group - Persona
Rome Fortune & CeeJ - loloU
Mani Coolin - Hope 4 The Youth
Tinase - Amethyst
Childish Major & Matik Estrada - Community Service
Mondo Drag - Mondo Drag
Future - 56 Nights
Modest Mouse - Strangers to Ourselves
Death Grips - Jenny Death
Earl Sweatshirt - I Don't Like Shit, I Don't Go Outside
Ludacris - Ludaversal
Z-Ro - Melting the Crown
Action Bronson - Mr. Wonderful
Rapper Big Pooh & Apollo Brown - Words Paint Pictures
Sufjan Stevens - Carrie and Lowell
Kendrick Lamar - To Pimp A Butterfly
Wale - The Album About Nothing
Smoke DZA - Ringside 3
Shlohmo - Dark Red
Rodney Hazard - Victim Volunteer
Wiz Khalifa & Ty Dolla $ign - Talk About It in the Morning
Harry Fraud - Blue/Green
Sosay - 6 Pills Later
Khori4 - Paradox
Sahtyre - LSD Saga
Curren$y - Pilot Talk 3
Courtney Barnett - Sometimes I Sit and Think, Sometimes I Just Sit
Gucci Mane - Trap House 5
Red Pill - Look What This World Did To Us
Ikey - Green Card
GTA V Soundtrack - Welcome to Los Santos
Young Thug - Barter 6
Jazz Cartier - Marauding in Paradise
Trinidad James - Trips to Trinidad
Luniz - High Timez
Curren$y - Even More Saturday Night Car Tunes
Audio Push - The Good Vibe Tribe
Tim Gent - Clarksville Nights
Yelawolf - Love Story
Billy Woods - Today I Wrote Nothing
Tyler the Creator - Cherry Bomb
Kehlani - You Should Be Here
Towkio - .Wav Theory
Clear Soul Forces - Fab 5ive
Oddisee - The Good Fight
Daytona & Harry Fraud - M.I.N.K.S.
Snoop Dogg - Bush
STS & RJD2 - STS & RJD2
Blur - The Magic Whip
Hiatus Kaiyote - Choose Your Weapon
Creative Gold - MVP Race
Nappy Roots - 40 Akerz Project
The Mountain Goats - Beat The Champ
OG Maco - Tax Free
OG Maco - OGZAY
Nacho Picasso - The Witchtape
Camp Lo - Ragtime Hightimes
Onra - Fundamentals
Django Django - Born Under Saturn
ISHi - Spring Pieces
Chavis Chandler - The Call of the Wild
A$AP Rocky - A.L.L.A
Donnie Trumpet & The Social Experiment - Surf
Dr. Cosmo's Tape Lab - Beyond the Silver Sea
Onyx - Against All Authorities
Jim O ' Rourke - Simple Songs
Thee Oh Sees - Mutilator Defeated At Last
Denzel Curry - 32 Zel/Planet Shrooms
Lil Ugly Mane - Third Side of the Tape 
Slum Village - Yes
Czarface - Every Hero Needs a Villain
Leon Bridges - Coming Home
The Doppelgangaz - Parts Unknown
MarQ Spekt - The Grilchy Era
Knxwledge - Hud_Dreems
Opio & Free The Robots - The Subconscious Mind
Deniro Farrar - Cliff of Death II
The Alchemist - Israeli Salad
Tyga - The Gold Album
Daye Jack - Soul Glitch
Shamir - Ratchet
Miguel - Wildheart
Retch - Finesse the World
Zion I - The Sun Moon and Stars
Skyzoo - Music For My Friends
Willie The Kid - The Fly 3
Lil Wayne - Free Weezy Album
Ghostface Killah - Twelve Reasons To Die II
Main Attrakionz - 808s and Dark Grapes III
Hurt Everybody - 2K47
Tame Impala - Currents
The Alchemist - Retarded Alligator Beats
Quelle Chris - Innocent Country
My Morning Jacket - Waterfall
Future - Dirty Sprite 2
Joie Kathos - Floaters
Everything Everything - Get To Heaven
Psychedelic Ensemble - Takes a Nap During a B-Movie
Ceschi - Broken Bone Ballads
Pete Rock - Petestrumentals Vol. 2
Wilco - Star Wars
Machine Gun Kelly - Fuck It
Clarence Clarity - No Now
Jedi Mind Tricks - The Thief and the Fallen
Gunplay - Living Legend
Madchild - Silver Tongued Devil
Meek Mill - Dreams Worth More Than Money
L'Orange & Kool Keith - Time Astonishing
Omen - Elephant Eyes
Chief Keef - Bang 3
Warren G - Regulate......G-Funk Era Part 2
Chance The Rapper & Lil B - Free Based Freestyles
Curren$y - Cathedral
Dr. Dre - Compton
Mick Jenkins - Waves
Sadistik x Kno - Phantom Limbs
FKA Twigs  - M3LL155X
2 Chainz - Trapavelli Tre
Chelsea Wolfe - Abyss
Jamie XX - In Colour
Built to Spill - Untethered Moon
The Weeknd - Beauty Behind The Madness
Stalley - The Laughing Introvert
Sean Price - Songs in the Key of Price
Beach House - Depression Cherry
Lupe Fiasco - Pharaoh Height 2/30
Travis $cott - Rodeo
Miley Cyrus - Miley Cyrus & Her Dead Pets
Rick Ross - Black Dollar
Jay Rock - 90059
Mickey Factz - Y-3
Gary Clark Jr. - The Story of Sonny Boy Slim
Mac Miller - Good: A.M
The Underachievers - Evermore: The Art of Duality
Young Thug - Slime Season
Dr. Yelik - Ootheca
Blackalicious - Imani Vol. 1
Scallops Hotel - Plain Speaking
Big Grams - Big Grams
YG, Blanco, and DB Tha General - California Lovin'
Roddy and T.Y. - Bendin Corners
Lil Herb - Ballin Like Kobe
Deacon the Villain - Peace or Power
Milo - So the Flies Don't Come
Asaad - Young 27
Young Jeezy - Politically Correct
Mr. Muthafuckin eXquire - Live Forever
Florence + The Machine - How Big, How Blue, How Beautiful
Big K.R.I.T - It's Better This Way
Ras Kass & Jack Splash - Breakfast at Banksy's
L'Orange & Jeremiah Jae - The Night Took Us In
D.R.A.M - GahDamn EP
IsaiahThe3rd - Sinner Sunday
Young Thug - Slime Season 2
Blu, MED, and Madlib - Bad Neighbor
Fetty Wap - Fetty Wap
Goldlink - And After That, We Didn't Talk
EarthGang - Strays With Rabies
Busdriver - Thumbs
Pell  - Limbo
Talib Kweli & 9th Wonder - Indy 500
Freddie Gibbs - Shadow of a Doubt
Redman - Mudface
Logic - The Incredible True Story
Carly Rae Jepsen - EMOTION
Oneotrix Point Never - Garden of Delete
Scarface - Deeply Rooted
Homeboy Sandman & Aesop Rock - Lice
Deafheaven - New Bermuda
Julia Holter - Have You In My Wilderness
Grimes - Art Angels
Riverside - Love, Fear, and the Time Machine
Iron Maiden - The Book of Souls
Wolf Alice - My Love Is Cool
Pusha T - Darkest Before Dawn: The Prelude
Cage The Elephant - Tell Me I'm Pretty
Kid Cudi - Speedin Bullet To Heaven